wwwwwwwwwwwwwww
w...w.....w...w
w...w.........w
w......wwwwwwww
www.......w...w
w...w.....w...w
ww.....wwww...w
w.....ww......w
w..w........www
w...wwww..w...w
w.............w
wwww......w...w
w..w..w...w...w
w.....w...w...O
wwwwwwwwwwwwwww
